*************
*...........*
*.......**..*
*.***.......*
*.......*****
*****.......*
*.......***.*
*.****......*
*...........*
*************
